############
#..........#
#....MM.M..#
#..........#
#..........#
#...C...M..#
#.M.....M.M#
#....M....M#
#......M...#
#..........#
#..........#
###########T
